0,0,0,0,0,127,0,0,127,127,0,0
0,0,0,0,0,127,127,127,127,126,0,0
0,0,0,0,0,127,127,127,127,127,0,0
0,0,0,0,0,127,127,127,0,128,0,0
0,0,0,0,127,127,127,127,127,128,0,0
0,0,126,0,127,0,127,126,127,0,0,0
0,0,127,127,127,0,0,0,127,0,0,0
0,0,127,127,0,0,0,127,127,126,0,0
0,0,131,126,128,0,0,127,127,0,0,0
0,0,131,127,128,0,0,126,127,0,0,0
0,0,0,127,0,0,0,127,127,0,0,0
0,0,0,127,0,0,0,127,127,0,0,0
0,0,0,127,0,0,0,126,127,0,0,0
0,0,0,127,0,127,127,127,127,0,0,0
0,0,0,126,0,127,127,127,127,0,0,0
0,0,0,127,0,0,126,127,127,0,0,0
0,0,0,126,0,0,127,127,127,0,0,0
0,0,0,127,0,0,127,128,126,0,0,0
127,127,127,127,127,127,127,128,127,127,127,127
